00000000000000000000000000000000
00000000000000000000000000000000
00000000110001000000000000000000
00000000000000000000000000000000
00000001011010100000000000000000
00000000000000000000000000000000
00000001110110100000000000000000
00000000000000000000000000000000
00000010000000000000000000000000
00000000000000000000000000000000
00000001110110100000000000000000
00000000000000000000000000000000
00000001011010100000000000000000
00000000000000000000000000000000
00000000110001000000000000000000
00000000000000000000000000000000
00000000000000000000000000000000
00000000000000000000000000000000
11111111001111000000000000000000
00000000000000000000000000000000
11111110100101100000000000000000
00000000000000000000000000000000
11111110001001100000000000000000
00000000000000000000000000000000
11111110000000000000000000000000
00000000000000000000000000000000
11111110001001100000000000000000
00000000000000000000000000000000
11111110100101100000000000000000
00000000000000000000000000000000
11111111001111000000000000000000
00000000000000000000000000000000
00000000000000000000000000000000
00000000000000000000000000000000
00000000110001000000000000000000
00000000000000000000000000000000
00000001011010100000000000000000
00000000000000000000000000000000
00000001110110100000000000000000
00000000000000000000000000000000
00000010000000000000000000000000
00000000000000000000000000000000
00000001110110100000000000000000
00000000000000000000000000000000
00000001011010100000000000000000
00000000000000000000000000000000
00000000110001000000000000000000
00000000000000000000000000000000
00000000000000000000000000000000
00000000000000000000000000000000
11111111001111000000000000000000
00000000000000000000000000000000
11111110100101100000000000000000
00000000000000000000000000000000
11111110001001100000000000000000
00000000000000000000000000000000
11111110000000000000000000000000
00000000000000000000000000000000
11111110001001100000000000000000
00000000000000000000000000000000
11111110100101100000000000000000
00000000000000000000000000000000
11111111001111000000000000000000
00000000000000000000000000000000
