0000000000000000
0000000000000000
0000000000000000
0000000000000000
0000000000000000
0000000000000000
0000000000000000
0000000000000000
0000000000000000
0000000000000000
0000000000000000
0000000000000000
0000000000000000
0000000000000000
0000000000000000
0000000000000000
0000000000000000
0000000000000000
0000000000000000
0000000000000000
0000000000000000
0000000000000000
0000000000000000
0000000000000000
0000000000000000
0000000000000000
0000000000000000
0000000000000000
0000000000000000
0000000000000000
0000000000000000
0000000000000000
1101101000110000
1101101000110000
1101110111100010
0001101111111110
1110010100111111
0001000110110011
0000110111100100
0001111110101001
1111001100001101
0000001010010100
0000000101110110
0001011000101000
1111111110000101
0001000001111011
0000110110000011
0000001001111101
0000000000000000
1111111111111110
1111111111111110
0000000000000001
1111111111111101
0000000000000000
0000000000000100
0000000000000001
0000000000000001
1111111111111111
0000000000000011
1111111111111100
1111111111111111
0000000000000001
0000000000000000
0000000000000000
